NO ./textures/north.xpm
SO ./textures/south.xpm
WE ./textures/west.xpm
EA ./textures/east.xpm

F -1,100,0
C 225,30,0

1111111
10N0001
1000001
1000001
1111111
